9155555113
C69115542A
BF806FFFAA
AFEC157FAA
AFFFAFFF86
813FAFD503
AAEFAFFF82
AC394553AA
ABAAD39442
C6C4544556

1,1
4,9
NEEEEEEESSSSSSSSWWSWW
